あーく	アーク	名詞
あいあんうぃんぐ	アイアンウィング	名詞
あいあんくっく	アイアンクック	名詞
あいすふぉーす	アイスフォース	名詞
あいどる	アイドル	名詞
あいのむち	愛のムチ	名詞
あおいげっこうのはな	青い月光の花	名詞
あおいほうせき	青い宝石	名詞
あおだけどうじ	あおだけ童子	名詞
あかいげっこうのはな	赤い月光の花	名詞
あかいさんご	赤いサンゴ	名詞
あかいほうせき	赤い宝石	名詞
あかいらい	アカイライ	名詞
あかちぇっく	赤チェック	名詞
あかりりす	アカリリス	固有一般
あくばー	アクバー	名詞
あくましんかん	あくま神官	名詞
あくまばらい	悪魔ばらい	名詞
あぐらに	アグラニ	固有地名
あくりょうのかみがみ	悪霊の神々	固有一般
あくろにあ	アクロニア	固有地名
あくろばっとすたー	アクロバットスター	名詞
あげはらんぶ	アゲハ乱舞	名詞
あさしん	アサシン	名詞
あさしんえみゅー	アサシンエミュー	名詞
あさしんくろー	アサシンクロー	名詞
あさしんぶらっど	アサシンブラッド	固有一般
あさの	麻の	名詞
あさのいと	麻の糸	名詞
あしおび	脚帯	名詞
あじと	アジト	固有地名
あしばらい	足ばらい	名詞
あしひれ	足ヒレ	名詞
あすたろと	アスタロト	名詞
あすとるてぃあ	アストルティア	名詞
あすとるにうむ	アストルニウム	名詞
あすらおう	アスラ王	固有一般
あずらん	アズラン	固有地名
あっくす	アックス	名詞
あっくすどらごん	アックスドラゴン	固有一般
あてな	アテナ	名詞
あぬびす	アヌビス	名詞
あびすそるじゃー	アビスソルジャー	固有一般
あぶないみずぎ	あぶない水着	名詞
あぽろんの	アポロンの	名詞
あまぐもの	あまぐもの	名詞
あまつかぜ	天ツ風	固有地名
あまつゆのしずく	雨つゆのしずく	名詞
あみぐつ	あみぐつ	名詞
あみごて	あみごて	名詞
あもーるのみず	アモールの水	名詞
あもでうす	アモデウス	名詞
あらぐね	アラグネ	名詞
あらくれちゃっぴー	あらくれチャッピー	名詞
あらはぎーろ	アラハギーロ	名詞
あるうぇ	アルウェ	名詞
あるけみすとん	アルケミストン	名詞
あるてみすの	アルテミスの	名詞
あるみらーじ	アルミラージ	名詞
あろえおに	アロエおに	名詞
あろーいんぷ	アローインプ	名詞
あろるど	アロルド	名詞
あんこくたいじゅのは	暗黒大樹の葉	名詞
あんこくたいじゅのばんにん	暗黒大樹の番人	名詞
あんこくのじゅもく	暗黒の樹木	名詞
あんるしあ	アンルシア	固有一般
いーぐる	イーグル	名詞
いーたー	イーター	名詞
いーぶるふらい	イーブルフライ	名詞
いえてぃ	イエティ	名詞
いえろーあい	イエローアイ	名詞
いえろーしっくる	イエローシックル	名詞
いえろばんぐる	イエロバングル	名詞
いおぐらんで	イオグランデ	固有一般
いおなずん	イオナズン	固有一般
いおら	イオラ	固有一般
いかずちの	いかずちの	名詞
いしす	イシス	名詞
いしつぶて	石つぶて	名詞
いせき	遺跡	固有地名
いちのしょ	壱の書	名詞
いっかくうさぎ	いっかくウサギ	名詞
いっかつ	一喝	名詞
いっせんづき	一閃突き	名詞
いっど	イッド	名詞
いっとうりょうだん	一刀両断	名詞
いつわりの	偽りの	固有一般
いての	射手の	名詞
いとほぐし	糸ほぐし	名詞
いなずまの	いなずまの	名詞
いなみの	イナミノ	固有地名
いにしえのじゅえき	いにしえの樹液	名詞
いばらの	いばらの	名詞
いむい	イムイ	固有地名
いやしの	いやしの	名詞
いやしのあめ	いやしの雨	名詞
いやりんぐ	イヤリング	名詞
いらい	依頼	名詞
いらいしょ	依頼書	名詞
いれいざそう	イレイザ草	名詞
いわとびあくま	岩とびあくま	名詞
いんきゅばす	インキュバス	名詞
いんじゃ	隠者	名詞
いんてり	インテリ	名詞
ヴぁーす	ヴァース	固有地名
ヴぁいぱーふぁんぐ	ヴァイパーファング	名詞
うぃっちねいる	ウィッチネイル	名詞
うぃっぷ	ウィップ	名詞
ういんぐえっじ	ウイングエッジ	名詞
ういんぐたいがー	ウイングタイガー	名詞
うぃんぐぶろう	ウィングブロウ	名詞
うえ	上	名詞
うぇいとぶれいく	ウェイトブレイク	名詞
うぇすたん	ウェスタン	名詞
うぇっとすーつ	ウェットスーツ	名詞
うぇでぃ	ウェディ	固有一般
うぇなーるしぇる	ウェナールシェル	名詞
ヴぇりなーど	ヴェリナード	固有地名
ヴぇりなーどじょう	ヴェリナード城	固有地名
うぉー	ウォー	名詞
うたよみ	歌詠み	固有一般
うっでぃあい	ウッディアイ	名詞
うでおび	腕帯	名詞
うどらー	ウドラー	名詞
うみかぜのどうくつ	海風の洞くつ	固有地名
うみなりの	うみなりの	名詞
うみやしのは	ウミヤシの葉	名詞
うるべあ	ウルベア	固有地名
うるわしきのこ	うるわしキノコ	名詞
うろこの	うろこの	名詞
うんじょうこ	雲上湖	固有地名
えいちぴーぱさー	ＨＰパサー	名詞
えいちぴーりんく	ＨＰリンク	固有一般
えいどす	エイドス	名詞
えくりぷす	エクリプス	名詞
えぜそる	エゼソル	固有地名
えぜそると	エゼソルト	名詞
えっじ	エッジ	名詞
えてーね	エテーネ	固有地名
えぴすてーさ	エピステーサ	固有地名
えびるそーさらー	エビルソーサラー	固有一般
えびるちくりん	エビルチクリン	名詞
えびるとれんと	エビルトレント	固有一般
えびるほーく	エビルホーク	名詞
えむぴーぱさー	ＭＰパサー	名詞
えむぴーぶれいく	ＭＰブレイク	名詞
えむぴーりんく	ＭＰリンク	固有一般
えめらるどーん	エメラルドーン	固有一般
えものよび	エモノ呼び	固有一般
えりみねーたー	エリミネーター	固有一般
えるじゅ	エルジュ	名詞
えるだーどらごん	エルダードラゴン	固有一般
えるとな	エルトナ	名詞
えるとなすいせん	エルトナスイセン	名詞
えるふ	エルフ	固有一般
えるふののみぐすり	エルフの飲み薬	名詞
えろすの	エロスの	名詞
えんたしすまん	エンタシスマン	固有一般
えんどおぶしーん	エンドオブシーン	固有一般
えんばん	延板	名詞
えんぶの	えんぶの	名詞
えんらーじゃ	エンラージャ	固有一般
おうぐんし	王軍師	固有一般
おうけのはか	王家の墓	固有地名
おうと	王都	固有地名
おーが	オーガ	固有一般
おおかみあたっく	オオカミアタック	名詞
おおきなうろこ	大きなうろこ	名詞
おおきなかいがら	大きな貝がら	名詞
おおきなかせき	大きな化石	名詞
おおきなこうら	大きなこうら	名詞
おおきなほね	大きなホネ	名詞
おーぐりーど	オーグリード	名詞
おおたきのぼり	大滝のぼり	名詞
おおたて	大盾	名詞
おーでぃーんぼう	オーディーンボウ	名詞
おーでぃす	オーディス	名詞
おーぶ	オーブ	名詞
おーれん	オーレン	名詞
おかると	オカルト	名詞
おぐりどほーん	オグリドホーン	名詞
おしりす	オシリス	名詞
おせあのす	オセアノス	名詞
おたからはんたー	お宝ハンター	名詞
おにおーん	オニオーン	名詞
おにきすの	オニキスの	名詞
おにぐもの	オニグモの	名詞
おの	オノ	固有一般
おのむそう	オノむそう	名詞
おばけきゃんどる	おばけキャンドル	名詞
おばけとまと	おばけトマト	名詞
おばけひとで	おばけヒトデ	名詞
おまねきのつばさ	お招きのつばさ	名詞
おもいでのつぼ	思い出のツボ	名詞
おやぶんの	おやぶんの	名詞
おりはるこん	オリハルコン	名詞
おるせこ	オルセコ	固有地名
おるっぱ	オルッパ	固有地名
おるふぁ	オルファ	固有地名
おるふぇあ	オルフェア	固有地名
おんみょうどうの	陰陽道の	名詞
がーごいる	ガーゴイル	固有一般
がーとらんと	ガートラント	固有地名
かいけつますく	かいけつマスク	名詞
かいじゅう	海獣	固有地名
かいしん	会心	固有一般
かいしんひっちゅう	会心必中	名詞
かいちゅう	怪蟲	名詞
かいちょう	怪鳥	固有地名
かいてい	海底	固有地名
かいと	カイト	名詞
かいどう	街道	固有地名
かいとうの	かいとうの	名詞
かうんたしょう	カウンタ小	名詞
かうんただい	カウンタ大	名詞
かえんぎり	かえん斬り	名詞
かえんむかで	かえんムカデ	名詞
かおすえっじ	カオスエッジ	固有一般
かおもじ	(^-^)	名詞
かおもじ	(^0^)/	名詞
かおもじ	o(^▽^)o	名詞
かおもじ	(´∀｀)	名詞
かおもじ	ヽ(´ー｀)ノ	名詞
かおもじ	(^ω^)	名詞
かおもじ	(・∀・)	名詞
かおもじ	(・ω・)!	名詞
かおもじ	(・ω・)つ	名詞
かおもじ	(｀・ω・´)	名詞
かおもじ	(゜ω゜=)	名詞
かおもじ	(ノ∀｀*)	名詞
かおもじ	(*´д｀*)	名詞
かおもじ	(・ω・)ノ	名詞
かおもじ	ノシ	名詞
かおもじ	d(^ー゜*)	名詞
かおもじ	Σ(・ω・ノ)ノ	名詞
かおもじ	━(゜∀゜)━!	名詞
かおもじ	(｀・ω・´)ゞ	名詞
かおもじ	(_ _)zzZ	名詞
かおもじ	щ(゜Д゜щ)	名詞
かおもじ	(゜Д゜≡゜Д゜)	名詞
かおもじ	└(゜ー゜ )┐	名詞
かおもじ	ヾ(・_・)	名詞
かおもじ	...φ(..)	名詞
かおもじ	|彡サッ	名詞
かおもじ	(T-T)	名詞
かおもじ	(>_<)	名詞
かおもじ	(´;ω;｀)	名詞
かおもじ	(ノД｀)	名詞
かおもじ	(^-^;)	名詞
かおもじ	(｀□´)	名詞
かおもじ	(-皿-#)	名詞
かおもじ	(´・ω・｀)	名詞
かおもじ	|ω・｀)	名詞
かおもじ	m(_ _)m	名詞
かおもじ	(-人-;)	名詞
かおもじ	(笑)	名詞
かおもじ	(怒)	名詞
かおもじ	(泣)	名詞
かおもじ	orz	名詞
かおもじ	ミ☆	名詞
かおもじ	☆。．：＊：・	名詞
かおもじ	。．＊・’゜☆	名詞
ががい	ガガイ	名詞
かがみいし	かがみ石	名詞
かがやきのじゅえき	かがやきの樹液	名詞
かがりびのいし	かがり火の石	名詞
がくしゃの	学者の	名詞
がくと	岳都	固有地名
かくとうじょう	格闘場	固有地名
かざりだな	飾り棚	名詞
かじせつび	鍛冶設備	名詞
かしの	かしの	名詞
かじはんまー	鍛冶ハンマー	名詞
かすたむや	カスタム屋	固有一般
かぜきりの	かぜきりの	名詞
かぜなき	風泣き	固有一般
かぜの	かぜの	名詞
かたびら	かたびら	名詞
かたみのおるごーる	形見のオルゴール	名詞
がたら	ガタラ	固有地名
かたりべの	かたりべの	名詞
かちーふ	カチーフ	名詞
かちこちくるみ	カチコチくるみ	名詞
がちゃこっこ	ガチャコッコ	名詞
かっちゅうあり	かっちゅうアリ	名詞
かっぷ	割符	名詞
がにらす	ガニラス	名詞
がねーしゃえびる	ガネーシャエビル	固有一般
かばりあー	カバリアー	名詞
かびん	花びん	名詞
かぶと	かぶと	名詞
かぶとわり	かぶと割り	名詞
がまのあぶら	ガマのあぶら	名詞
かみのいぶき	神の息吹	名詞
かみはるむい	カミハルムイ	固有地名
かみはるむいじょう	カミハルムイ城	固有地名
かみよ	神代	固有地名
かむいら	カムイラ	固有地名
かめさま	カメさま	名詞
かめの	カメの	名詞
かめれおんまん	カメレオンマン	名詞
からーりんぐや	カラーリング屋	名詞
がらが	ガラガ	固有地名
がらすのこびん	ガラスの小ビン	名詞
かりうどの	かりうどの	名詞
かりば	狩り場	名詞
かりょくあげ	火力上げ	名詞
かるさどら	カルサドラ	固有地名
かるであ	カルデア	固有地名
がるば	ガルバ	名詞
かるべろびゅーと	カルベロビュート	名詞
かれいど	枯れ井戸	固有地名
かれいどすこーぷ	カレイドスコープ	名詞
かろっと	カロット	名詞
がんせきおとし	岩石おとし	固有一般
かんだた	カンダタ	固有一般
かんだたこぶん	カンダタこぶん	固有一般
がんどう	岩道	固有地名
かんながけ	カンナがけ	名詞
かんねつふうじ	完熱封じ	名詞
かんふー	カンフー	名詞
きありー	キアリー	固有一般
きありく	キアリク	固有一般
きーえんぶれむ	キーエンブレム	名詞
きいろのほうせき	黄色の宝石	名詞
ぎがすらっしゅ	ギガスラッシュ	名詞
ぎがでいん	ギガデイン	固有一般
ぎがでーもん	ギガデーモン	名詞
ぎがぼんばー	ギガボンバー	固有一般
ぎがんてす	ギガンテス	名詞
ぎがんとどらごん	ギガントドラゴン	名詞
ぎがんとひるず	ギガントヒルズ	名詞
きじゅつしの	きじゅつしの	名詞
ぎずも	ギズモ	名詞
きちぇっく	黄チェック	名詞
きぬの	きぬの	名詞
きのこやま	きのこ山	固有地名
きぼりのしんぞう	木彫りの神像	名詞
きまいらろーど	キマイラロード	名詞
ぎゃくたすきぬい	逆たすきぬい	名詞
ぎゃくりゅうせいぼり	逆流星彫り	名詞
ぎゃすもん	ギャスモン	名詞
ぎゃすもんはーと	ギャスモンハート	名詞
きゃっと	キャット	名詞
きゃんせるしょっと	キャンセルショット	名詞
きゅうきょくしんがん	究極心眼	名詞
きゅうすけ	キュウスケ	名詞
きゅうどうしゃの	求道者の	名詞
きゅうりょう	丘陵	固有地名
きゅららな	キュララナ	固有地名
きょうかい	教会	固有一般
きょうかがじぇっとぜろしき	強化ガジェット零式	固有一般
きょうき	狂鬼	名詞
ぎょうじゃの	ぎょうじゃの	名詞
きょうせんし	狂戦士	名詞
きょうぞう	胸像	名詞
きょうもーどぼす	強モードボス	名詞
きょじんの	きょじんの	名詞
きょぞう	巨像	固有一般
きょだいけんのさび	巨大剣のサビ	名詞
きょだいなうろこ	巨大なうろこ	名詞
きょだいなこうら	巨大なこうら	名詞
きょびょう	巨猫	固有地名
きよめのみず	きよめの水	名詞
きょりゅうのす	巨竜の巣	固有地名
きらー	キラー	名詞
きらーじゃぐりんぐ	キラージャグリング	名詞
きらーとーち	キラートーチ	名詞
きらーぱんさー	キラーパンサー	固有一般
きらーぴあす	キラーピアス	名詞
きらーぴっける	キラーピッケル	名詞
きらーふぁんぐ	キラーファング	名詞
きらーぶーん	キラーブーン	名詞
きらきらぽーん	キラキラポーン	名詞
きらぱんくろ	キラパン黒	固有一般
きらぱんしろ	キラパン白	固有一般
きらめきいんく	きらめきインク	名詞
きりか	キリカ	固有地名
きりさきぴえろ	きりさきピエロ	名詞
ぎるぎっしゅ	ギルギッシュ	名詞
ぎるざっど	ギルザッド	固有地名
ぎるど	ギルド	名詞
ぎるどいせききょかしょう	ギルド移籍許可証	名詞
きれいなえだ	きれいな枝	名詞
きれいなかいがら	キレイな貝がら	名詞
きれいなかいすい	きれいな海水	名詞
きわくしっくい	木枠しっくい	名詞
きんか	金貨	名詞
ぎんか	銀貨	名詞
ぎんがむ	ギンガム	名詞
きんぐ	キング	名詞
きんぐひどら	キングヒドラ	固有一般
きんぐれお	キングレオ	名詞
きんじゅ	禁呪	固有地名
きんの	きんの	名詞
ぎんぶち	ぎんぶち	名詞
くぁばるな	クァバルナ	名詞
ぐーる	グール	名詞
くぎ	クギ	名詞
ぐざいむーぶ	具材ムーブ	名詞
くさったしたい	くさった死体	名詞
くじゃくの	くじゃくの	名詞
くすしの	くすしの	名詞
くどぅす	クドゥス	固有地名
くびかざり	首かざり	名詞
くびまき	首まき	名詞
くもの	クモノ	固有一般
くらうん	クラウン	名詞
ぐらこすの	グラコスの	名詞
くらっしゅ	クラッシュ	名詞
ぐらでぃうす	グラディウス	名詞
ぐらぶ	グラブ	名詞
ぐらんぜどーら	グランゼドーラ	名詞
ぐらんぜどーらこう	グランゼドーラ港	固有地名
ぐらんぜどーらじょう	グランゼドーラ城	固有地名
ぐらんぜどーらりょう	グランゼドーラ領	固有地名
ぐらんどたいたす	グランドタイタス	名詞
ぐらんどねびゅら	グランドネビュラ	固有一般
ぐりーんあい	グリーンアイ	名詞
ぐりーんしざー	グリーンシザー	名詞
ぐりごんだんす	グリゴンダンス	名詞
くりむぞん	クリムゾン	名詞
くりむぞんぐれいぶ	クリムゾングレイブ	固有一般
ぐりんばんぐる	グリンバングル	名詞
ぐるぐ	グルグ	固有地名
ぐれいとらいどん	グレイトライドン	名詞
ぐれーと	グレート	名詞
ぐれごーる	グレゴール	固有地名
くれせんと	クレセント	名詞
ぐれむりん	グレムリン	名詞
ぐれん	グレン	固有地名
ぐれんじょう	グレン城	固有地名
ぐれんじょうかまち	グレン城下町	名詞
くろー	クロー	名詞
くろーしない	クローしない	名詞
くろがねの	くろがねの	名詞
くろかびこぞう	くろカビこぞう	固有一般
くろきはなむこ	黒き花婿	名詞
くろす	クロス	名詞
ぐろすなー	グロスナー	名詞
くろひょうの	黒ヒョウの	名詞
くろぶちかく	黒ぶち角	名詞
くろぶちまる	黒ぶち丸	名詞
ぐろりすのしずく	グロリスのしずく	名詞
くわっと	クワット	名詞
ぐんたいがに	ぐんたいガニ	名詞
けいけんち	経験値	名詞
けいこく	渓谷	固有地名
げいざー	ゲイザー	名詞
げいにんごろし	芸人殺し	名詞
げいにんごろしのひげ	芸人殺しのヒゲ	名詞
けーきや	ケーキ屋	固有地名
けがれのうず	けがれの渦	名詞
けがれのたに	けがれの谷	固有地名
けせらんぱせらん	ケセランパセラン	名詞
けだもん	ケダモン	名詞
けつぁるこあとるす	ケツァルコアトルス	名詞
けっかよち	結果予知	名詞
けっしょう	結晶	名詞
けっしょうが	結晶牙	名詞
けものづき	けもの突き	名詞
けもののかわ	けものの皮	名詞
けらこーな	ケラコーナ	固有地名
げりゅおん	ゲリュオン	名詞
げると	ゲルト	固有地名
げんきだま	元気玉	名詞
げんこつだけ	げんこつダケ	名詞
げんしじゅうの	原始獣の	名詞
けんじゃ	賢者	名詞
けんじゃの	けんじゃの	名詞
げんじゅうのかわ	幻獣の皮	名詞
げんじゅうのほね	幻獣のホネ	名詞
けんじん	賢人	名詞
けんせいの	拳聖の	名詞
げんぶの	げんぶの	名詞
こあくまねいる	こあくまネイル	名詞
こあくまの	こあくまの	名詞
こうぐんろく	行軍録	名詞
こうげきあっぷ	攻撃アップ	名詞
こうじょうのしゅごせい	荒城の守護精	名詞
こうち	高地	固有地名
こうていたっぷ	こうていタップ	名詞
こうふくのもこもこ	幸福のモコモコ	名詞
こうや	荒野	固有地名
こうりょうちたい	荒涼地帯	固有地名
ごーすと	ゴースト	名詞
ごーどん	ゴードン	名詞
こーぷすふらい	コープスフライ	名詞
こおりの	こおりの	名詞
こおりのけっしょう	氷のけっしょう	名詞
こおりのじゅもく	氷の樹木	名詞
ごーるでんごーれむ	ゴールデンゴーレム	名詞
ごーるでんとーてむ	ゴールデントーテム	名詞
ごーるどすとーん	ゴールドストーン	名詞
ごーるどふぃんがー	ゴールドフィンガー	名詞
ごーれむ	ゴーレム	名詞
こがらしの	こがらしの	名詞
ごぎょうのとう	五行の塔	固有地名
こくそうたい	穀倉帯	固有地名
こくりゅうまる	黒竜丸	名詞
ここらた	ココラタ	固有地名
こさっくしーぷ	コサックシープ	固有一般
こしだれ	こしだれ	名詞
ごしっく	ゴシック	名詞
こしぬの	こしぬの	名詞
こぞう	こぞう	名詞
こだいのせんじん	古代の戦刃	名詞
ごっどじゃぐりんぐ	ゴッドジャグリング	固有一般
こっとんそう	コットン草	名詞
こて	こて	名詞
ことぶきーの	コトブキーノ	名詞
こにうぇあ	コニウェア	固有地名
こねこ	子ネコ	名詞
このはの	木の葉の	名詞
こびん	小ビン	名詞
こぶどうぎ	古武道着	名詞
こぶどうの	古武道の	名詞
ごぶる	ゴブル	固有地名
ごるすら	ゴルスラ	固有一般
こるっと	コルット	固有地名
ごるば	ゴルバ	名詞
こん	棍	固有一般
こんしぇるじゅ	コンシェルジュ	固有一般
こんしんぎり	渾身斬り	名詞
こんぶたいしょう	こんぶ大将	固有一般
こんぺきのひすい	紺碧のヒスイ	名詞
ざあぐ	ザアグ	固有地名
さーどんのてした	サードンの手下	名詞
さーべる	サーベル	名詞
さーぺんと	サーペント	名詞
さーまり	サーマリ	固有地名
さいおとこ	サイおとこ	名詞
ざいがす	ザイガス	名詞
さいきょうしょうひん	最強商品	名詞
さいくつじょう	採掘場	固有地名
さいくろぷす	サイクロプス	名詞
さいくろんあっぱー	サイクロンアッパー	固有一般
さいこますたー	サイコマスター	固有一般
さいしんぶ	最深部	固有地名
さいどわいんだー	サイドワインダー	名詞
さいほうばり	さいほう針	名詞
ざいもく	材木	名詞
さいやくのおう	災厄の王	名詞
さいれす	サイレス	名詞
さいんぜめ	サインぜめ	名詞
さうざんど	サウザンド	名詞
さうるすろーど	サウルスロード	名詞
ざお	ザオ	固有一般
ざおらる	ザオラル	固有一般
ざおりく	ザオリク	固有一般
さがん	砂岩	固有地名
ざき	ザキ	固有一般
さぎょうぎうえ	作業着上	名詞
さぎょうぎした	作業着下	名詞
さぎょうぎじょうげ	作業着上下	名詞
ざぐばん	ザグバン	固有地名
ざぐびな	ザグビナ	固有地名
さくらのはなびら	さくらの花びら	名詞
さざなみのきせき	さざなみの貴石	名詞
さざみれ	サザミレ	固有地名
さざんくろす	サザンクロス	名詞
さじんの	さじんの	名詞
さたんめいる	サタンメイル	名詞
ざっけす	ザッケス	名詞
さとりの	さとりの	名詞
さばきの	さばきの	名詞
さばんなうっど	サバンナウッド	名詞
さばんなのみず	サバンナの水	名詞
さびついたつるぎ	さびついた剣	名詞
さぶなっく	サブナック	名詞
さふらん	サフラン	名詞
ざま	ザマ	固有地名
さまーうるふ	サマーウルフ	名詞
さみだれづき	さみだれ突き	固有一般
ざめは	ザメハ	固有一般
ざらき	ザラキ	固有一般
ざらきーま	ザラキーマ	固有一般
さらまんだー	サラマンダー	名詞
さんぐらす	サングラス	名詞
さんぞくうるふ	さんぞくウルフ	名詞
さんぞくの	さんぞくの	名詞
さんぞくのさーべる	さんぞくのサーベル	名詞
さんだーしゃうと	サンダーシャウト	固有一般
さんだーふろっぐ	サンダーフロッグ	名詞
さんだーぼると	サンダーボルト	名詞
さんたがーる	サンタガール	固有一般
さんち	山地	固有地名
さんどう	山道	固有地名
さんとうしのおの	三闘士のオノ	名詞
さんとうのしゅごれい	三闘の守護霊	名詞
さんどふるーつ	サンドフルーツ	名詞
さんのしょ	参の書	名詞
さんばいうち	３倍打ち	名詞
さんばいぬい	３倍ぬい	名詞
さんばいぼり	３倍彫り	名詞
さんもんのせきしょ	三門の関所	固有地名
ざんやのたち	斬夜の太刀	名詞
しいかのまもりて	詩歌の守り手	名詞
じーがんふ	ジーガンフ	名詞
しーざーれいんぼー	シーザーレインボー	名詞
しーどっぐ	シードッグ	名詞
しーぶす	シーブス	名詞
しーるどあたっく	シールドアタック	名詞
しーるどこぞう	シールドこぞう	名詞
しーるどぶれいく	シールドブレイク	名詞
しえら	シエラ	固有地名
じぇりーまん	ジェリーマン	名詞
しぇんろん	シェンロン	名詞
しおかぜそう	しおかぜ草	名詞
しおどーあ	シオドーア	名詞
じかいしーるど	磁界シールド	固有一般
しかくいいえ	四角い家	名詞
しぐるど	シグルド	名詞
じごくの	じごくの	名詞
じごくのぬえ	じごくのヌエ	固有一般
じごくのねぎぼーず	じごくのネギボーズ	名詞
じごくのはさみ	じごくのハサミ	名詞
ししもん	獅子門	固有地名
したんの	したんの	名詞
しっぷうじんらい	疾風迅雷	固有一般
しなやかなえだ	しなやかな枝	名詞
しのしょ	死の書	名詞
じばしりうち	地ばしり打ち	名詞
じばりあ	ジバリア	固有一般
じばりーな	ジバリーナ	固有一般
しばりうち	しばり打ち	名詞
じばりか	ジバリカ	固有一般
じばるんば	ジバルンバ	固有一般
しゃーまん	シャーマン	名詞
しゃいにんぐぼう	シャイニングボウ	固有一般
じゃいら	ジャイラ	固有地名
しゃいんすこーる	シャインスコール	名詞
じゃがーめいじ	ジャガーメイジ	名詞
じゃけっと	ジャケット	名詞
しゃどう	シャドウ	名詞
しゃどーのーぶる	シャドーノーブル	名詞
しゃぷか	シャプカ	名詞
じゃみらす	ジャミラス	名詞
じゃんぐるはしら	ジャングル柱	名詞
しゅくふくのつえ	しゅくふくの杖	名詞
しゅごしゃ	守護者	名詞
じゅじゅつし	呪術師	名詞
しゅびりょく	守備力	名詞
しゅぷりんがー	シュプリンガー	名詞
じゅもんれんきん	呪文錬金	名詞
しゅらの	しゅらの	名詞
じゅりあんて	ジュリアンテ	名詞
じゅれーとう	ジュレー島	固有地名
じゅれっと	ジュレット	固有地名
じゅれりあ	ジュレリア	固有地名
しょ	書	名詞
じょうげうち	上下打ち	名詞
しょうげんきだま	小元気玉	名詞
じょうたいがーど	状態ガード	名詞
じょうどくけしそう	上どくけしそう	名詞
じょうぶなえだ	じょうぶな枝	名詞
じょうぶなかなぐ	じょうぶな金具	名詞
じょうやくそう	上やくそう	名詞
しょうりゅうぼり	昇竜彫り	名詞
しょきゅうまほうせんし	初級魔法戦士	名詞
しょくにんうであて	職人腕あて	名詞
しょくにんずきん	職人頭巾	名詞
しょくにんぼう	職人帽	名詞
しらぎの	白木の	名詞
しるくそう	シルク草	名詞
しるばー	シルバー	名詞
しるばーあい	シルバーアイ	名詞
しるばーさーくる	シルバーサークル	名詞
しろいげっこうのはな	白い月光の花	名詞
しろばらのきし	しろバラのきし	名詞
しんかいのしゅごしゃ	深海の守護者	名詞
しんかんのかぎたば	神官のカギ束	名詞
しんけっかよち	真・結果予知	名詞
しんとうめっきゃく	心頭滅却	名詞
しんの	真の	固有一般
しんぺいしきゅう	新兵支給	名詞
しんぺいの	神兵の	名詞
しんりの	しんりの	名詞
すい	スイ	固有地名
すいーつなはしら	スイーツな柱	名詞
すいかん	水環	固有地名
すいぜん	スイゼン	固有地名
すいちゅうめがね	水中メガネ	名詞
すいへいぬい	水平ぬい	名詞
すいりゅう	水竜	名詞
すいりゅうのかまえ	水流のかまえ	固有一般
すかうとあたっく	スカウトアタック	固有一般
すから	スカラ	固有一般
すからべーだー	スカラベーダー	名詞
すからべきんぐ	スカラベキング	名詞
すかるがるー	スカルガルー	名詞
すきゃんだる	スキャンダル	名詞
すきる	スキル	固有一般
すきるくらっしゅ	スキルクラッシュ	固有一般
ずきん	ズキン	名詞
すくらっちゃー	スクラッチャー	名詞
すくると	スクルト	固有一般
すこーぴおんている	スコーピオンテイル	名詞
すざくの	すざくの	名詞
すたー	スター	名詞
すたーでびる	スターデビル	名詞
すたっふ	スタッフ	名詞
すたんしょっと	スタンショット	固有一般
すちーむ	スチーム	名詞
ずっしーど	ズッシード	固有一般
すてぃっく	スティック	名詞
すてーじ	ステージ	名詞
すてっき	ステッキ	名詞
すてられたしろ	捨てられた城	名詞
すとーむふぉーす	ストームフォース	名詞
すとーんまん	ストーンマン	名詞
すなだまり	砂だまり	固有地名
すねあて	すねあて	名詞
すのーもん	スノーモン	名詞
すぱーくしょっと	スパークショット	名詞
すぱいく	スパイク	名詞
すぴあ	スピア	名詞
すもーるぐーる	スモールグール	名詞
すもーるたわー	スモールタワー	名詞
すらいむおしゃればな	スライムおしゃれ花	名詞
すらいむぜりー	スライムゼリー	名詞
すらいむぶろう	スライムブロウ	名詞
すらいむべす	スライムベス	名詞
すらたわー	スラタワー	名詞
すりーぷだがー	スリープダガー	名詞
するどいきば	するどいキバ	名詞
するどいつめ	するどい爪	名詞
せいいん	聖印	名詞
せいきし	聖騎士	名詞
せいきしの	せいきしの	名詞
せいぎんのどくろあらい	聖銀のどくろあらい	名詞
せいけんづき	せいけん突き	名詞
せいこうかくりつぷらす	成功確率プラス	名詞
せいこうしゅーと	成功シュート	名詞
せいじゃのうた	聖者の詩	名詞
せいじゅう	聖獣	名詞
せいじょのまもり	聖女の守り	名詞
せいしんとういつ	精神統一	名詞
せいち	聖地	固有地名
せいてん	晴天	固有一般
せいてん	星天	固有一般
せいてんのこな	星天の粉	名詞
せいどうの	せいどうの	名詞
せいなるいのり	聖なる祈り	名詞
せいぼくのえだ	聖木の枝	名詞
せいれいの	せいれいの	名詞
せいれいのかなぐ	せいれいの金具	名詞
せいれいのこな	せいれいの粉	名詞
せいれいのみ	精霊の実	名詞
せいれーんの	セイレーンの	名詞
せいんず	セインズ	名詞
せかいじゅ	世界樹	名詞
せかいじゅのは	せかいじゅの葉	名詞
せきしつ	石室	固有地名
せきとう	石塔	固有一般
せきどう	石洞	固有地名
ぜきるのせいこう	ゼキルの聖杭	名詞
せつげん	雪原	固有地名
せと	セト	名詞
ぜどら	ゼドラ	固有地名
ぜどらごん	ゼドラゴン	固有一般
ぜぶらまんてぃす	ゼブラマンティス	固有一般
せらふぃむの	セラフィムの	名詞
せるげいなす	セルゲイナス	名詞
せるけと	セルケト	名詞
せれど	セレド	名詞
せれどっと	セレドット	固有地名
せれもにー	セレモニー	名詞
せんき	戦記	名詞
ぜんざげいにんの	前座芸人の	名詞
せんし	戦士	固有一般
せんしょくや	染色屋	名詞
せんとう	戦闘	固有一般
せんとうのしゅごき	尖塔の守護鬼	名詞
せんぺい	尖兵	名詞
せんりょう	染料	名詞
ぞうおのせいれいじゅ	憎悪の精霊樹	名詞
そうてんまざん	蒼天魔斬	名詞
そうへい	僧兵	名詞
そうりゅううち	双竜打ち	名詞
そうりゅうぼり	双竜彫り	名詞
そーさりー	ソーサリー	名詞
そーど	ソード	名詞
そーどふらいやー	ソードフライヤー	固有一般
そーどぶれいかー	ソードブレイカー	名詞
そふぁしょう	ソファ小	名詞
そふぁだい	ソファ大	名詞
そんおう	村王	名詞
ぞんび	ゾンビ	名詞
だーくないと	ダークナイト	名詞
だーくぱんさー	ダークパンサー	名詞
だーくふぉーす	ダークフォース	名詞
だーくほびっと	ダークホビット	名詞
だーてぃらびっつ	ダーティラビッツ	名詞
だーま	ダーマ	固有地名
だいおうきっず	だいおうキッズ	名詞
たいがーくろー	タイガークロー	名詞
たいがぼり	大河彫り	名詞
だいかんながけ	大カンナがけ	名詞
だいきりん	ダイキリン	名詞
たいけん	大剣	名詞
だいけんじゃの	大賢者の	名詞
たいごく	大獄	名詞
たいこのさきん	太古の砂金	名詞
たいこのぬし	太古のぬし	名詞
だいさんりん	大山林	固有地名
だいじなわっぺん	大事なワッペン	名詞
だいしょうりゅうぼり	大昇竜彫り	名詞
たいせいあっぷ	耐性アップ	名詞
だいせいこうかくりつぷらす	大成功確率プラス	名詞
だいせいこうしゃっふる	大成功シャッフル	名詞
たいたにあ	タイタニア	名詞
だいちくだき	大地くだき	名詞
だいちのはこぶね	大地の箱舟	名詞
だいどうけつ	大洞穴	固有地名
たいふーん	タイフーン	名詞
たいぷじー	タイプＧ	名詞
だいぼうぎょ	大ぼうぎょ	名詞
たいぼくざん	たいぼく斬	名詞
たいま	退魔	固有一般
だいまどう	だいまどう	名詞
たいまのたち	退魔の太刀	名詞
たいりくかんてつどうぱす	大陸間鉄道パス	名詞
だがー	ダガー	名詞
たきのぼり	滝のぼり	名詞
たくと	タクト	名詞
たこつきがい	タコツキ貝	名詞
たこめってぃーしゃつ	タコメッＴシャツ	固有一般
たこめっと	タコメット	名詞
だず	ダズ	固有地名
だすとん	ダストン	名詞
だっしゅらん	ダッシュラン	名詞
たつじんの	たつじんの	名詞
たつじんのこきゅう	達人の呼吸	固有一般
たっぷだんす	タップダンス	名詞
たっぷでびる	タップデビル	名詞
たっぷぺんぎー	タップペンギー	名詞
たてがえし	たて返し	名詞
たなと	タナト	名詞
たなとすはんと	タナトスハント	名詞
だぶるたてがえし	ダブルたて返し	名詞
だぶるよこがえし	ダブルよこ返し	名詞
たほどらきー	タホドラキー	名詞
たまどめ	玉どめ	名詞
たまねぎまん	たまねぎマン	名詞
ためるに	ためる弐	名詞
だらず	ダラズ	固有地名
たんけん	短剣	名詞
だんさー	ダンサー	名詞
だんすでびる	ダンスデビル	名詞
たんすみみっく	たんすミミック	固有一般
だんそうたい	断層帯	固有地名
だんだだ	ダンダダ	固有地名
だんでぃ	ダンディ	名詞
ちいさなうろこ	小さなうろこ	名詞
ちいさなかいがら	小さな貝がら	名詞
ちいさなかせき	小さな化石	名詞
ちいさなこうら	小さなこうら	名詞
ちいさなほね	小さなホネ	名詞
ちいさなみんかのもけい	小さな民家の模型	名詞
ちぇいさー	チェイサー	名詞
ちぇすと	チェスト	名詞
ちかつうろう	地下通廊	固有地名
ちかどう	地下堂	固有地名
ちからの	ちからの	名詞
ちぎー	チギー	名詞
ちゃーじたっくる	チャージタックル	固有一般
ちゃむーる	チャムール	名詞
ちゃんぷすたー	チャンプスター	名詞
ちゅーざー	チューザー	固有地名
ちゅーんなっぷ	チューンナップ	固有一般
ちょうけっかよち	超・結果予知	名詞
ちょうげんきだま	超元気玉	名詞
ちょうたいがぼり	超大河彫り	名詞
ちょうてんどうし	超天道士	名詞
ちょうてんゆうぎ	超天遊戯	名詞
ちょうとれーす	蝶とレース	名詞
ちょうねくたい	ちょうネクタイ	名詞
ちょうはやぶさぎり	超はやぶさ斬り	固有一般
ちょうぼうそうまほうじん	超暴走魔法陣	固有一般
ちょうよんれんうち	超４連打ち	名詞
ちょーかー	チョーカー	名詞
ちょこしん	チョコ神	名詞
ちょっぴ	チョッピ	固有地名
ちり	チリ	名詞
ちりゅうのつの	地竜のツノ	名詞
ちんこん	鎮魂	名詞
ついすとーち	ツイストーチ	固有一般
ついんくる	ツインクル	名詞
ついんすわろー	ツインスワロー	名詞
つけものいし	つけもの石	名詞
つすくる	ツスクル	固有地名
つっこみ	ツッコミ	名詞
つぼれんきん	ツボ錬金	名詞
つぼれんきんせつび	ツボ錬金設備	名詞
つめ	ツメ	名詞
つよびやき	強火焼き	名詞
つららすらいむ	つららスライム	名詞
つりーはうす	ツリーハウス	名詞
つるぎ	つるぎ	名詞
つんどら	ツンドラ	名詞
でぃばいんすぺる	ディバインスペル	固有一般
てーぶるしょう	テーブル小	名詞
てーぶるだい	テーブル大	名詞
でーもん	デーモン	名詞
てかげんうち	てかげん打ち	名詞
てじなしの	手品師の	名詞
ですごーごん	デスゴーゴン	名詞
ですとろいやー	デストロイヤー	名詞
ですぱろっと	デスパロット	名詞
ですぷりーすと	デスプリースト	名詞
ですまえすとろ	デスマエストロ	名詞
てっこうざん	鉄甲斬	固有一般
でっどぺっかー	デッドペッカー	名詞
でびる	デビル	名詞
でびるんちゃーむ	デビルンチャーム	名詞
でふぇる	デフェル	固有地名
でまとーど	デマトード	固有地名
てまねきりんぐ	てまねきリング	名詞
てらのらいなー	テラノライナー	名詞
でるくろあ	デルクロア	固有地名
てんかむそう	天下無双	名詞
てんしのすず	天使のすず	名詞
てんしのそーま	天使のソーマ	名詞
てんしのまもり	天使の守り	名詞
てんしのや	天使の矢	名詞
てんしょんばーん	テンションバーン	固有一般
てんしょんぶーすと	テンションブースト	名詞
てんたこるす	テンタコルス	固有一般
でんたざうるす	デンタザウルス	名詞
てんちのかまえ	天地のかまえ	名詞
てんとふう	テント風	名詞
てんま	天魔	名詞
てんまぶぐじてん	天馬武具辞典	名詞
てんめいのいくさおとめ	天命の戦乙女	名詞
とう	塔	固有地名
どうか	銅貨	名詞
とうぎじょう	闘技場	固有地名
どうくつ	洞くつ	固有地名
どうぐつかい	どうぐ使い	固有一般
どうぐばいかじゅつ	どうぐ倍化術	固有一般
どうぐはんいかじゅつ	どうぐ範囲化術	固有一般
とうこんうち	とうこん討ち	名詞
とうこんえきす	とうこんエキス	名詞
とうし	闘士	名詞
とうぞくの	盗賊の	名詞
とうばつたい	討伐隊	名詞
どうもん	洞門	固有地名
とーる	トール	名詞
とが	トガ	固有地名
とがす	トガス	固有地名
どくいもむし	どくイモムシ	名詞
どくがの	どくがの	名詞
とくどくけしそう	特どくけしそう	名詞
どくどくぞんび	どくどくゾンビ	名詞
どくどくへどろ	どくどくヘドロ	名詞
どくばり	どくばり	名詞
とくやくそう	特やくそう	名詞
どくろ	ドクロ	名詞
とげうに	とげウニ	名詞
とげじょぼー	とげジョボー	固有一般
どこでもくらっかー	どこでもクラッカー	名詞
どっぐらまっこい	ドッグラマッコイ	名詞
どでかにーどる	どデカニードル	固有一般
どらきー	ドラキー	名詞
どらきーま	ドラキーマ	名詞
どらごん	ドラゴン	名詞
どらごんがいあ	ドラゴンガイア	固有一般
どらごんぎり	ドラゴン斬り	名詞
どらごんすらっしゅ	ドラゴンスラッシュ	名詞
どらごんぞんび	ドラゴンゾンビ	名詞
どらごんている	ドラゴンテイル	名詞
どらごんの	ドラゴンの	名詞
どらごんのかわ	ドラゴンの皮	名詞
どらごんのつの	ドラゴンのツノ	名詞
どらごんのほね	ドラゴンのホネ	名詞
とらっぷじゃまー	トラップジャマー	固有一般
とらまないし	トラマナ石	名詞
どらむくらっしゅ	ドラムクラッシュ	名詞
とりかとらぷす	トリカトラプス	名詞
とりの	トリの	名詞
どるくま	ドルクマ	固有一般
どるせりん	ドルセリン	固有一般
どるぼーど	ドルボード	固有一般
どるま	ドルマ	固有一般
どるまーじゅ	ドルマージュ	固有一般
どるまどん	ドルマドン	固有一般
どるもーあ	ドルモーア	固有一般
どるわーむ	ドルワーム	固有地名
とれじゃー	トレジャー	名詞
どれすあっぷや	ドレスアップ屋	名詞
どろぬーば	ドロヌーバ	名詞
とろる	トロル	名詞
とろるきんぐ	トロルキング	名詞
とろるばっこす	トロルバッコス	名詞
とろろしょうぐん	とろろ将軍	固有一般
どわーふ	ドワーフ	固有一般
どわーふふうはしら	ドワーフ風柱	名詞
どわちゃかおいる	ドワチャカオイル	名詞
どわちゃっか	ドワチャッカ	名詞
とんかち	トンカチ	名詞
どんぐりべびー	どんぐりベビー	名詞
とんぶれろ	トンブレロ	名詞
ないと	ナイト	名詞
ないときゃっと	ナイトキャット	名詞
ないとすないぱー	ナイトスナイパー	名詞
ないとめーあ	ナイトメーア	名詞
ないふ	ナイフ	名詞
なうまんぼーぐ	ナウマンボーグ	固有一般
ながぐつ	ながぐつ	名詞
なぎり	ナギリ	固有地名
なぎりどう	ナギリ洞	固有地名
なぐあ	ナグア	固有地名
なげきの	なげきの	名詞
なげきのぼうれい	なげきの亡霊	名詞
なげきむーん	なげきムーン	固有一般
なしーむ	ナシーム	固有地名
なすびってぃーしゃつ	ナスビッＴシャツ	固有一般
なすびなーら	ナスビナーラ	名詞
ななほしの	ナナホシの	名詞
ななめうち	ななめ打ち	名詞
ななめむーぶ	ななめムーブ	名詞
なぶれっと	ナブレット	名詞
なるびあ	ナルビア	固有地名
なわばり	ナワ張り	固有地名
なんぱせん	難破船	固有地名
にーそ	ニーソ	名詞
にーどるまん	ニードルマン	固有一般
にーべるのゆびわ	ニーベルのゆびわ	名詞
にころい	ニコロイ	名詞
にじいろのぬのきれ	にじいろの布きれ	名詞
にちりんの	にちりんの	名詞
にのしょ	弐の書	名詞
にばいうち	２倍打ち	名詞
にばいぬい	２倍ぬい	名詞
にばいぼり	２倍彫り	名詞
にんじゃかったー	ニンジャカッター	名詞
ぬーくそう	ヌーク草	名詞
ぬーでびる	ヌーデビル	名詞
ぬかどこすらいむ	ぬかどこスライム	固有一般
ぬすっとうさぎ	ぬすっとウサギ	名詞
ぬすっとの	ぬすっとの	名詞
ねいるびーすと	ネイルビースト	名詞
ねくろばるさ	ネクロバルサ	名詞
ねこずな	ネコずな	名詞
ねこの	ネコの	名詞
ねこまんまのみ	ネコマンマの実	名詞
ねたちょう	ネタ帳	名詞
ねっくれす	ネックレス	名詞
ねっさどう	熱砂洞	固有地名
ねったいうりん	熱帯雨林	固有地名
ねらいうち	ねらい打ち	名詞
ねらいぼり	ねらい彫り	名詞
ねらいやき	ねらい焼き	名詞
ねるげる	ネルゲル	名詞
のーぶる	ノーブル	名詞
のろいのいわ	のろいの岩	名詞
のろいのかげ	呪いの影	名詞
はーげん	ハーゲン	名詞
ぱーてぃー	パーティー	名詞
ばーどしゅーと	バードシュート	名詞
はーとないと	ハートナイト	名詞
ばーにんぐばーど	バーニングバード	名詞
ばーは	バーハ	固有一般
ぱーぷるあい	パープルアイ	名詞
ばあらっく	バアラック	名詞
ばあるぜぶぶ	バアルゼブブ	名詞
はいおく	廃屋	固有地名
ばいきると	バイキルト	固有一般
はいこう	廃坑	固有地名
ばいざー	バイザー	名詞
ばいしおん	バイシオン	固有一般
ぱいそん	パイソン	名詞
ばうぎあ	バウギア	名詞
はおんりゅう	波怨竜	名詞
はかいおう	破戒王	固有一般
はがねの	はがねの	名詞
ばぎ	バギ	固有一般
ばぎま	バギマ	固有一般
はくあいの	はくあいの	名詞
はくあのかいがら	白亜の貝がら	名詞
はくじゃの	白蛇の	名詞
ばくだんいわ	ばくだん岩	名詞
ばぐど	バグド	名詞
ぱくれ	パクレ	名詞
ばくれつうち	ばくれつ打ち	名詞
はげんの	破幻の	名詞
はごろも	はごろも	名詞
ばさぐらんで	バサグランデ	名詞
ばざっくす	バザックス	名詞
ばさらーな	バサラーナ	名詞
はしゃの	はしゃの	名詞
はじゃの	はじゃの	名詞
はじゃふね	破邪舟	名詞
はじゅの	破呪の	名詞
ばじりすくの	バジリスクの	名詞
ばずず	バズズ	名詞
ばすたー	バスター	名詞
ばすたーど	バスタード	名詞
ばすてと	バステト	名詞
はちがね	はちがね	名詞
はちまき	はちまき	名詞
ばっさいましんかい	伐採マシン改	名詞
はっするだんす	ハッスルダンス	名詞
はどくの	破毒の	名詞
ばとます	バトマス	名詞
ばどりある	バドリアル	固有地名
ばどりー	バドリー	固有地名
ばとる	バトル	名詞
ばとるすたんぱー	バトルスタンパー	名詞
ばとるふぁん	バトルファン	名詞
ばとるふぉーく	バトルフォーク	名詞
ばとるりぼん	バトルリボン	名詞
ばとるれっくす	バトルレックス	固有一般
はながら	花柄	名詞
ばななとらっぷ	バナナトラップ	名詞
はなのみつ	花のみつ	名詞
はなふぶき	花ふぶき	名詞
ぱにぱにはにー	パニパニハニー	名詞
はぬまーん	ハヌマーン	名詞
はねとほし	羽と星	名詞
ばぶりん	バブリン	名詞
ぱぺっとまん	パペットマン	固有一般
はまのおふだ	破魔のおふだ	名詞
はもんえんぶ	波紋演舞	名詞
はやての	はやての	名詞
はやぶさぎり	はやぶさ斬り	名詞
はやぶさの	はやぶさの	名詞
はやよみのつえ	早詠みの杖	名詞
ぱらそる	パラソル	名詞
ぱらでぃん	パラディン	名詞
ばらもす	バラモス	固有一般
ばりくなじゃ	バリクナジャ	名詞
ばるけす	バルケス	名詞
ぱるちざん	パルチザン	名詞
ばるどる	バルドル	名詞
ばるばろっさ	バルバロッサ	名詞
ぱるぷんて	パルプンテ	名詞
ばろんないと	バロンナイト	名詞
ぱわーべると	パワーベルト	名詞
ぱわふるすろー	パワフルスロー	名詞
はんきゅうたいのかけら	半球体のかけら	名詞
ばんでっど	バンデッド	名詞
ぱんどらちぇすと	パンドラチェスト	固有一般
ぱんどらぼっくす	パンドラボックス	名詞
はんねつふうじ	半熱封じ	名詞
ぱんぷきっず	パンプキッズ	固有一般
はんまー	ハンマー	名詞
ぴあす	ピアス	名詞
びーすと	ビースト	名詞
びーすともーど	ビーストモード	固有一般
ひーとぎずも	ヒートギズモ	名詞
びーなすのなみだ	ビーナスのなみだ	名詞
ひいらぎどうじ	ヒイラギどうじ	固有一般
ぴおら	ピオラ	固有一般
ぴおらの	ピオラの	名詞
ぴおりむ	ピオリム	固有一般
ひかりのいし	ひかりの石	名詞
ひかりのかわ	光の河	名詞
ぴくしー	ピクシー	名詞
ひげ	ヒゲ	名詞
ひすいのかぎ	ヒスイのカギ	固有一般
びっぐ	ビッグ	名詞
びっぐさぼてん	ビッグサボテン	名詞
びっぐしーるど	ビッグシールド	名詞
びっぐすろーす	ビッグスロース	名詞
びっぐばん	ビッグバン	固有一般
びっくりさたん	びっくりサタン	名詞
ひっさつの	ひっさつの	名詞
ひっちゅうけん	必中拳	名詞
ひっぽきんぐ	ヒッポキング	名詞
ぴてっざ	ピテッザ	固有地名
ひとくいさーべる	ひとくいサーベル	名詞
ひとつめぴえろ	ひとつめピエロ	名詞
ひぷのす	ヒプノス	名詞
ひほう	秘法	名詞
ひぽせんし	ヒポせんし	名詞
ひぽぽさーどん	ヒポポ・サードン	名詞
ひめあ	ヒメア	名詞
ひやく	秘薬	名詞
ひやしこみ	冷やし込み	名詞
ひゃだるこ	ヒャダルコ	固有一般
ひゃど	ヒャド	固有一般
ひゅーざ	ヒューザ	名詞
ひゅぷのすはんと	ヒュプノスハント	名詞
びゅぶろす	ビュブロス	名詞
ひょうけつ	氷穴	固有地名
ひょうけつらんげき	氷結らんげき	名詞
ひょうちょうのはね	氷鳥のはね	名詞
ひょうでんのしゅごへい	氷殿の守護兵	名詞
ひょうめんがため	表面固め	名詞
ひらめきの	ひらめきの	名詞
ぴん	ピン	名詞
ぴんくたいふーん	ピンクタイフーン	固有一般
ぴんくぱーる	ピンクパール	名詞
ぴんくもーもん	ピンクモーモン	名詞
びんせん	便せん	名詞
ぴんもってぃーしゃつ	ピンモッＴシャツ	固有一般
ふぁいあふぉーす	ファイアフォース	名詞
ふぁらんくす	ファランクス	固有一般
ふぁるこん	ファルコン	名詞
ふぁんきーどらご	ファンキードラゴ	名詞
ふぁんとむ	ファントム	名詞
ぶいじゃんぷ	Ｖジャンプ	名詞
ぶいろん	Ｖロン	名詞
ぷーくぷっく	プークプック	固有一般
ふうしゃとう	風車塔	固有地名
ぶーなー	ブーナー	固有地名
ふうまの	ふうまの	名詞
ぶーめらん	ブーメラン	名詞
ふうら	フウラ	名詞
ぷーら	プーラ	固有地名
ふぇざー	フェザー	名詞
ふぇるあば	フェルアバ	固有地名
ふぇんさー	フェンサー	名詞
ふぇんさーまんと	フェンサーマント	名詞
ふぉーす	フォース	名詞
ふぉーすぶれいく	フォースブレイク	固有一般
ふぉすている	フォステイル	固有地名
ふぉすているでん	フォステイル伝	名詞
ふぉれすとどらご	フォレストドラゴ	固有一般
ふぉれすどん	フォレスドン	名詞
ぶきや	武器屋	固有一般
ふくしゅうき	復讐鬼	名詞
ぷくじるしのぬりぐすり	プク印のぬり薬	名詞
ぷくべりー	プクベリー	名詞
ふくめんばにー	ふくめんバニー	名詞
ぷくらんさふらん	プクランサフラン	名詞
ぷくらんど	プクランド	名詞
ぷくりぽ	プクリポ	固有一般
ぷくれっと	プクレット	固有地名
ふさふさの	フサフサの	名詞
ふさふさのけがわ	ふさふさの毛皮	名詞
ふしぎなかいそう	ふしぎな海草	名詞
ふしぎなどろどろ	ふしぎなドロドロ	名詞
ぷすごん	プスゴン	名詞
ぷちあーのん	プチアーノン	名詞
ぷでぃん	プディン	名詞
ぷてらのどん	プテラノドン	名詞
ぶどうえきす	ぶどうエキス	名詞
ぶとうか	武闘家	固有一般
ぶとうじょう	武闘場	固有地名
ふとうふくつ	不撓不屈	名詞
ぶとうま	舞踏魔	名詞
ふばーは	フバーハ	固有一般
ぷぷいあ	ププイア	固有地名
ふぶきの	ふぶきの	名詞
ぷぷれぽのみず	ププレポの水	名詞
ぷぺら	プペラ	固有地名
ぷよんたーげっと	プヨンターゲット	名詞
ふらいんぐです	フライングデス	名詞
ぶらうにー	ブラウニー	名詞
ぷらちな	プラチナ	名詞
ぷらちなうぃんぐ	プラチナウィング	名詞
ぷらちなこうせき	プラチナこうせき	名詞
ぷらちなの	プラチナの	名詞
ぷらちなもっこうとう	プラチナ木工刀	名詞
ぶらっくこんどる	ブラックコンドル	名詞
ぶらっくぱーる	ブラックパール	名詞
ぶらっくまんてぃす	ブラックマンティス	名詞
ぶらっど	ブラッド	名詞
ぶらっどそーど	ブラッドソード	名詞
ぶらっどぴっく	ブラッドピック	名詞
ふらわー	フラワー	名詞
ぶらんどんびーすと	ブランドンビースト	名詞
ぶらんまとっく	ブランマトック	固有一般
ぷりーすとないと	プリーストナイト	固有一般
ふりーずぶれーど	フリーズブレード	名詞
ぶりぎって	ブリギッテ	名詞
ぶりざーど	ブリザード	名詞
ぷりずにゃん	プリズニャン	名詞
ぷりずむ	プリズム	名詞
ふるいむらびとめいぼ	古い村人名簿	名詞
ぶるーあい	ブルーアイ	名詞
ふるーつ	フルーツ	名詞
ぶるーみんくす	ブルーミンクス	固有一般
ぶるさべーじ	ブルサベージ	名詞
ふるっか	フルッカ	名詞
ふるつわものの	古強者の	名詞
ふるびたおうけのほん	古びた王家の本	名詞
ぶるふぁんぐ	ブルファング	固有一般
ぶるべりーの	ブルベリーノ	名詞
ふれあぱうだー	フレアパウダー	名詞
ぶれいぶすとーん	ブレイブストーン	固有一般
ふれいむ	フレイム	名詞
ふれいむどっく	フレイムドック	名詞
ふれいや	フレイヤ	名詞
ぶれーど	ブレード	名詞
ぶれーどがーど	ブレードガード	名詞
ぷれしあんな	プレシアンナ	名詞
ぶれすくらっしゅ	ブレスクラッシュ	固有一般
ふろーずんばーど	フローズンバード	固有一般
ふろすとぎずも	フロストギズモ	名詞
ぶろっげん	ブロッゲン	名詞
ふろってぃ	フロッティ	名詞
ぶろんず	ブロンズ	名詞
ふわふわわたあめ	フワフワわたアメ	名詞
へヴぃちゃーじ	ヘヴィチャージ	名詞
べこん	ベコン	固有地名
ぺしゅや	ペシュヤ	固有地名
べすとすまいる	ベストスマイル	名詞
へなとす	ヘナトス	固有一般
へぱいとすのひだね	ヘパイトスのひだね	名詞
へぱいとすのほのお	ヘパイトスの炎	名詞
べびーさたん	ベビーサタン	固有一般
べびーさらまんだ	ベビーサラマンダ	名詞
べひーどす	ベヒードス	固有一般
べびーにゅーと	ベビーニュート	名詞
へびーめたる	ヘビーメタル	名詞
へびがわの	へびがわの	名詞
べびる	ベビル	名詞
べほいみ	ベホイミ	固有一般
べほいむ	ベホイム	固有一般
べほま	ベホマ	固有一般
べほまずん	ベホマズン	固有一般
べほまらー	ベホマラー	固有一般
べりある	ベリアル	名詞
へるかっちゃ	ヘルカッチャ	名詞
へるくらっしゃー	ヘルクラッシャー	名詞
へるごーすと	ヘルゴースト	名詞
へるこんだくたー	ヘルコンダクター	名詞
へるしーさー	ヘルシーサー	名詞
へるじゅらしっく	ヘルジュラシック	名詞
へるびーすと	ヘルビースト	名詞
べるふぇごる	ベルフェゴル	名詞
へるぼっくる	ヘルボックル	固有一般
べるむど	ベルムド	固有一般
べれす	ベレス	名詞
べろにゃーご	ベロニャーゴ	名詞
ぺろりん	ペロリン	名詞
べんがるくーん	ベンガルクーン	名詞
ぺんたぐらむ	ペンタグラム	名詞
ぺんだんと	ペンダント	名詞
ぽいずんとりる	ポイズントリル	名詞
ぽいずんりざーど	ポイズンリザード	名詞
ほいみ	ホイミ	固有一般
ぼう	帽	名詞
ほうかだい	烽火台	名詞
ぼうぐや	防具屋	固有一般
ぼうけんのしょ	冒険の書	名詞
ぼうし	ぼうし	名詞
ほうじゅ	宝珠	名詞
ぼうそうまほうじん	暴走魔法陣	名詞
ぼうと	亡都	固有地名
ぼうれいけんし	ぼうれい剣士	名詞
ほーくまん	ホークマン	固有一般
ぽーぽら	ポーポラ	固有地名
ほーりー	ホーリー	名詞
ほーりーらいと	ホーリーライト	固有一般
ぼーんくらっしゃー	ボーンクラッシャー	名詞
ぼーんないと	ボーンナイト	名詞
ぼーんぷりずなー	ボーンプリズナー	名詞
ほかほかすとーん	ホカホカストーン	名詞
ぼけ	ボケ	名詞
ほしくずの	ほしくずの	名詞
ほしくずのれしぴ	ほしくずのレシピ	名詞
ほしのかけら	ほしのカケラ	名詞
ほじょけん	補助券	名詞
ほたてわらびー	ホタテワラビー	名詞
ぼでぃーがーどよび	ボディーガード呼び	名詞
ぼでぃがーどよび	ボディガード呼び	名詞
ほねこうもり	ほねコウモリ	名詞
ほねりーだー	ほねリーダー	名詞
ほのおの	ほのおの	名詞
ほのおのじゅもく	炎の樹木	名詞
ほのぐらいはしら	ほのぐらい柱	名詞
ぽぽらぱ	ポポラパ	固有地名
ぽぽりあ	ポポリア	固有地名
ぼみえ	ボミエ	固有一般
ぼみおす	ボミオス	固有一般
ぽむぽむぼむ	ポムポムボム	名詞
ほらあな	ほら穴	固有地名
ぽらんぱんのしょじょう	ポランパンの書状	名詞
ぼるかの	ボルカノ	名詞
ぽるねあ	ポルネア	固有地名
ほろごーすと	ホロゴースト	固有一般
ぼろぬす	ボロヌス	固有地名
ぼろぼろのほん	ボロボロの本	名詞
ほわいとうっど	ホワイトウッド	名詞
ほわいとぱーる	ホワイトパール	名詞
まあもん	マアモン	名詞
まいすたー	マイスター	名詞
まいまいている	まいまいテイル	固有一般
まいゆ	マイユ	名詞
まがんの	まがんの	名詞
まぐまの	マグマの	名詞
まぐまろん	マグマロン	名詞
まぐんし	魔軍師	名詞
まけっかい	魔結界	名詞
まけんしの	まけんしの	名詞
まけんじゃ	魔賢者	名詞
まじかる	マジカル	名詞
まじすてっき	マジステッキ	名詞
まじっくあろー	マジックアロー	名詞
まじっくちゃくらむ	マジックチャクラム	名詞
まじっくとんかち	マジックトンカチ	名詞
まじっくふぁん	マジックファン	名詞
まじっくるーれっと	マジックルーレット	名詞
まじないし	まじないし	名詞
まじゅう	魔獣	固有地名
まじゅうの	まじゅうの	名詞
まじゅうのかわ	まじゅうの皮	名詞
まじゅうのさいえん	魔獣の菜園	固有地名
まじゅうのつの	まじゅうのツノ	名詞
まじゅうのねどこ	魔獣の寝床	固有地名
まじゅうのひだりつの	魔獣の左角	名詞
まじゅうのほね	まじゅうのホネ	名詞
まじゅうのみぎつの	魔獣の右角	名詞
ましょう	魔瘴	名詞
ましょうせき	魔瘴石	名詞
ましょうの	ましょうの	名詞
まじん	魔人	名詞
まじんぎり	まじん斬り	名詞
ましんへい	魔神兵	名詞
まじんへいし	魔人兵士	名詞
ますかれいど	マスカレイド	名詞
ますく	マスク	名詞
ますたー	マスター	名詞
またどーる	マタドール	名詞
まだらいちょう	まだらイチョウ	名詞
まだらくもいと	まだらくも糸	名詞
まだんて	マダンテ	固有一般
まちょうのとうもく	魔鳥の頭目	名詞
まっどふぃんがー	マッドフィンガー	名詞
まっどるーぱー	マッドルーパー	名詞
まてきの	まてきの	名詞
までゅらいと	マデュライト	名詞
まとうき	魔盗鬼	名詞
まどうしの	まどうしの	名詞
まどうのいし	魔導の石	名詞
まどうのかわ	魔導の皮	名詞
まどうのしょ	魔導の書	名詞
まどうのはぐるま	魔導の歯車	名詞
まどはんど	マドハンド	名詞
まどはんどろ	マドハン泥	名詞
まどろみの	まどろみの	名詞
まぬーさ	マヌーサ	固有一般
まぬーは	マヌーハ	固有一般
まひゃでどす	マヒャデドス	固有一般
まひゃど	マヒャド	固有一般
まふうじの	まふうじの	名詞
まへい	魔兵	名詞
まほうじん	魔法陣	固有一般
まほうせんしだん	魔法戦士団	名詞
まほうつかいの	魔法使いの	名詞
まほうのかなぐ	まほうの金具	名詞
まほうのじゅもく	まほうの樹木	名詞
まほうふ	魔法布	名詞
まほかんた	マホカンタ	固有一般
まほきて	マホキテ	固有一般
まほすて	マホステ	固有一般
まほせん	魔戦	名詞
まほたーん	マホターン	固有一般
まほとーん	マホトーン	固有一般
まほとら	マホトラ	固有一般
まほとらのころも	マホトラのころも	名詞
まほりー	マホリー	固有一般
まぽれーな	マポレーナ	名詞
まものつかい	まもの使い	固有一般
まもりの	まもりの	名詞
まゆうしゃ	魔勇者	固有一般
まよけの	まよけの	名詞
まりーぶ	マリーブ	名詞
まりーん	マリーン	名詞
まりょくかくせい	魔力かくせい	名詞
まりょくのいぶき	魔力の息吹	名詞
まりょくのつち	まりょくの土	名詞
まりょくれんきん	魔力錬金	名詞
まりんすらいむ	マリンスライム	名詞
まるいいえ	丸い家	名詞
まんと	マント	名詞
まんねんざくらのはな	万年桜の花	名詞
まんねんゆき	まんねん雪	名詞
まんまー	マンマー	名詞
みかわしの	みかわしの	名詞
みきわめのいし	みきわめの石	名詞
みずたまどらごん	みずたまドラゴン	名詞
みすてりぴらー	ミステリピラー	固有一般
みずの	水の	名詞
みずのじゅもく	水の樹木	名詞
みだれうち	みだれ打ち	名詞
みとら	ミトラ	名詞
みどりたからばこ	緑宝箱	固有一般
みどりのこけ	緑のコケ	名詞
みどりのほうせき	緑の宝石	名詞
みにでーもん	ミニデーモン	固有一般
みはりとう	見張り塔	固有地名
みみっく	ミミック	名詞
みゃるじ	ミャルジ	名詞
みゅーず	ミューズ	固有地名
みゅるえる	ミュルエル	固有地名
みらくる	ミラクル	名詞
みらくるそーど	ミラクルソード	名詞
みらくるぞーん	ミラクルゾーン	名詞
みらくるぶき	ミラクル武器	名詞
みわくのりぼん	みわくのリボン	名詞
むーちょ	ムーチョ	固有一般
むーん	ムーン	名詞
むーんさると	ムーンサルト	名詞
むがのきょうち	無我の境地	名詞
むぎー	ムギー	名詞
むげん	夢幻	固有地名
むげんの	むげんの	名詞
むじ	無地	名詞
むしんこうげき	無心こうげき	名詞
むち	ムチ	固有一般
むちむちじょおうさま	ムチムチ女王様	名詞
むねあて	むねあて	名詞
むねんむそう	無念無想	固有一般
むらびと	村人	名詞
むるーど	ムルード	固有地名
めいおう	冥王	名詞
めいきょうしすい	明鏡止水	名詞
めいくあっぷ	メイクアップ	名詞
めいじきめら	メイジキメラ	名詞
めいじだすたー	メイジダスター	名詞
めいじどらきー	メイジドラキー	名詞
めいじゅう	冥獣	名詞
めいじゅうおう	冥獣王	名詞
めいじゅうの	冥獣の	名詞
めいせいち	名声値	名詞
めーだ	メーダ	名詞
めーだくいん	メーダクイン	名詞
めーだろーど	メーダロード	名詞
めがざる	メガザル	固有一般
めがとん	メガトン	名詞
めかにっく	メカニック	名詞
めがね	メガネ	名詞
めがぼんばー	メガボンバー	名詞
めがんて	メガンテ	固有一般
めぎすとりす	メギストリス	固有地名
めぎすとりすじょう	メギストリス城	固有地名
めぎどろーむ	メギドローム	名詞
めぎらざ	メギラザ	固有地名
めざめのはな	めざめの花	名詞
めたきん	メタキン	固有一般
めたすらの	メタスラの	名詞
めたっぴー	メタッピー	名詞
めだぱに	メダパニ	固有一般
めたるうぃんぐ	メタルウィング	名詞
めたるとらっぷ	メタルトラップ	名詞
めたるのかけら	メタルのカケラ	名詞
めたるほいみん	メタルホイミン	固有一般
めっさーら	メッサーラ	名詞
めでぃかるでばいす	メディカルデバイス	固有一般
めておえっじ	メテオエッジ	名詞
めら	メラ	固有一般
めらがいあー	メラガイアー	固有一般
めらぞーま	メラゾーマ	固有一般
めらみ	メラミ	固有一般
めらんざーな	メランザーナ	名詞
めるさんでぃ	メルサンディ	名詞
めるんすいしゃごう	メルン水車郷	固有地名
もーにんぐすたー	モーニングスター	名詞
もーもん	モーモン	名詞
もがりむ	モガリム	固有地名
もがれ	モガレ	固有地名
もこふる	モコフル	名詞
もこもこじゅう	モコモコじゅう	名詞
もだんばにー	モダンバニー	名詞
もっこうじゅつ	木工術	名詞
ものくる	モノクル	名詞
もひかんと	モヒカント	固有一般
ももいろさんしまい	ももいろ三姉妹	固有一般
もりなら	モリナラ	固有地名
もりはずれ	森外れ	固有地名
もりびと	守人	固有一般
もりびとの	森人の	名詞
もろばぎり	もろば斬り	名詞
もんすたーさかば	モンスター酒場	固有地名
もんすたーぞーん	モンスターゾーン	名詞
もんつき	紋付	固有一般
やーん	ヤーン	名詞
やいばの	やいばの	名詞
やえんかん	夜宴館	固有地名
やこうせき	夜光石	名詞
やしのみ	ヤシの実	名詞
やしゃの	やしゃの	名詞
やつざきあにまる	やつざきアニマル	名詞
やりがいのあるやりづくり	ヤリがいのある槍作り	名詞
やわらかいえだ	やわらかい枝	名詞
やわらかうーる	やわらかウール	名詞
ゆうひのいし	夕陽の石	名詞
ゆうわくえきす	ゆうわくエキス	名詞
ゆうわくの	ゆうわくの	名詞
ゆぐどらしる	ユグドラシル	名詞
ゆめみのはな	ゆめみの花	名詞
ようがんどう	溶岩洞	固有地名
ようがんのかけら	ようがんのカケラ	名詞
ようけんし	妖剣士	固有地名
ようせいたちのぽるか	妖精たちのポルカ	名詞
ようせいの	ようせいの	名詞
ようせいのこな	ようせいの粉	名詞
ようせいのめんか	妖精の綿花	名詞
ようま	妖魔	名詞
よこがえし	よこ返し	名詞
よこぬい	ヨコぬい	名詞
よせんさんかしょう	予選参加証	名詞
よみおくり	黄泉送り	名詞
よるのぱぴよん	よるのパピヨン	名詞
よろい	よろい	名詞
よわびやき	弱火焼き	名詞
よんれんうち	４連打ち	名詞
らーでぃす	ラーディス	固有地名
らーでぃすおうとう	ラーディス王島	固有地名
らいじんの	らいじんの	名詞
らいでいん	ライデイン	固有一般
らいと	ライト	名詞
らいとふぉーす	ライトフォース	名詞
らいのすきんぐ	ライノスキング	名詞
らいのそるじゃー	ライノソルジャー	名詞
らいめいづき	雷鳴突き	名詞
らぎ	ラギ	固有地名
らぎー	ラギー	名詞
らぐあす	ラグアス	名詞
らずばーん	ラズバーン	名詞
らせつの	らせつの	名詞
らせんうち	らせん打ち	名詞
らっからん	ラッカラン	固有地名
らっからんとう	ラッカラン島	固有地名
らっきー	ラッキー	名詞
らに	ラニ	固有地名
らにあっか	ラニアッカ	固有地名
らばに	ラバニ	固有地名
らぴっどすてっき	ラピッドステッキ	固有一般
らぶりー	ラブリー	名詞
らみざ	ラミザ	名詞
らりほー	ラリホー	固有一般
らんがーお	ランガーオ	固有地名
らんす	ランス	名詞
らんどいんぱくと	ランドインパクト	名詞
らんどん	ランドン	固有地名
らんどんくいな	ランドンクイナ	名詞
らんどんふっと	ランドンフット	固有地名
らんぷのまじん	ランプのまじん	固有一般
らんぷれんきん	ランプ錬金	名詞
りざーど	リザード	名詞
りざーどまん	リザードマン	名詞
りじん	リジン	名詞
りせき	離席	名詞
りびんぐすたちゅー	リビングスタチュー	名詞
りべほいみ	リベホイミ	固有一般
りべほいむ	リベホイム	固有一般
りべりお	リベリオ	名詞
りほいみ	リホイミ	固有一般
りゃな	リャナ	固有地名
りゅういーそー	リュウイーソー	名詞
りゅうきへい	りゅうき兵	名詞
りゅうさ	流砂	固有地名
りゅうせいぼり	流星彫り	名詞
りゅうとけんのみずたま	竜と剣の水玉	名詞
りゅうのおまもり	竜のおまもり	名詞
りゅなんのてがみ	リュナンの手紙	名詞
りょう	領	固有地名
りようけん	利用券	名詞
りょうてつえ	両手杖	固有一般
りょくや	緑野	固有地名
りりぱっと	リリパット	名詞
りれみと	リレミト	固有一般
りんぐ	リング	名詞
りんくる	リンクル	固有地名
りんごはしら	リンゴ柱	名詞
りんじゃ	リンジャ	固有地名
りんじゃはる	リンジャハル	固有地名
るーら	ルーラ	名詞
るーらすとーん	ルーラストーン	名詞
るーん	ルーン	名詞
るかなん	ルカナン	固有一般
るかに	ルカニ	固有一般
るなな	ルナナ	名詞
るばんか	ルバンカ	名詞
るふの	ルフの	名詞
るふのたて	ルフの盾	名詞
るるるりーち	ルルルリーチ	名詞
れいだめてす	レイダメテス	固有地名
れいどう	霊堂	固有地名
れいにー	レイニー	名詞
れいのせんれい	零の洗礼	名詞
れいぴあ	レイピア	名詞
れいぶん	レイブン	固有一般
れいんぼーふぁん	レインボーファン	名詞
れーなむ	レーナム	固有地名
れーん	レーン	固有地名
れおんびゅぶろ	レオン・ビュブロ	名詞
れがーす	レガース	名詞
れぎおん	レギオン	名詞
れじぇんど	レジェンド	名詞
れっこうけん	裂鋼拳	名詞
れっどあーちゃー	レッドアーチャー	名詞
れっどあい	レッドアイ	名詞
れっどべりー	レッドベリー	名詞
れとろなみずぎ	レトロな水着	名詞
れびゅーる	レビュール	固有地名
れむるのせいはい	レムルの聖杯	名詞
れんきん	錬金	固有一般
れんきんつぼ	錬金ツボ	名詞
れんきんらんぷ	錬金ランプ	名詞
れんごくてんま	れんごく天馬	名詞
れんじゃー	レンジャー	名詞
れんだーしあ	レンダーシア	名詞
れんどあ	レンドア	固有地名
ろいやるちゃーむ	ロイヤルチャーム	名詞
ろヴぉす	ロヴォス	固有地名
ろうがづき	狼牙突き	名詞
ろーず	ローズ	名詞
ろーぬ	ローヌ	固有地名
ろーりえの	ローリエの	名詞
ろくせいじん	六聖陣	名詞
ろざりお	ロザリオ	名詞
ろすとあたっく	ロストアタック	名詞
ろっかくぼう	六角ぼう	名詞
ろっど	ロッド	名詞
ろんぐ	ロング	名詞
ろんぐぼう	ロングボウ	名詞
ろんだ	ロンダ	固有地名
わいときんぐ	ワイトキング	名詞
わいやーまん	ワイヤーマン	名詞
わいるど	ワイルド	名詞
わかてげいにんの	若手芸人の	名詞
わかばのせいれい	若葉の精霊	名詞
わすれられし	忘れられし	固有一般
わるど	ワルド	固有地名
わんど	ワンド	名詞
